10 20
###################
#@              * #
#     #############
#####      &      #
#*     ############
#####             # 
# $  $           $#
#%$               #
###################