10 20
###################
#@                #
#     #############
#####      &      #
#      ############
#####             # 
# $              $#
#$            $  %#
###################
test level 4