########################### 
#@      Level             # @ - MAIN HERO
#      ###4###            # * - REGEN
#####                     # & - ENEMY
#*    &############       # $ - ITEM
# ###  ###### ### ##&     # % - END OF LEVEL
# * #             #       # 
#  #             #  *     #
#       /---     /---     #
#      /        /         #
#      |        |         #
#      |   ___  |   ___   #
#       \___|    \___|    #      
#$           &  #       %##
###########################