10 20
###################
#@              * #
#############     #
#      &      #####
#  ###########  * #
#              ####
#   $            $#
#        $      $%#
###################