10 20
###################
#@                #
#     #############
#####      &      #
#      ############
#####             # 
# $  $           $#
#%$               #
###################